+-+-+-+-+-+
|     | | |
+ +-+-+ + +
|   |   | |
+ + + + + +
| | | |   |
+-+ +-+ +-+
| | |     |
+ + + + + +
|     | | |
+-+-+-+-+-+
